ID,Name,Telugu,Hindi,English,Maths,Total
1,A,67,78,55,45,245
2,B,89,45,88,33,255
3,C,45,90,48,55,238
4,D,87,23,90,55,255
5,E,45,76,78,77,276
6,F,90,45,45,90,270
7,G,34,87,23,77,221
8,H,78,67,23,88,256
9,I,36,56,34,44,170
10,J,29,45,90,56,220
